#######
# B  .#
#   B #
# P  .#
#######