################
#              #
#  P    B   .  #
#     B      . #
################