################
#       B   .   #
#  P    B   .   #
#               #
################