#######
# B   #
#   B #
# P  .#
#######