#######
#     #
# P B #
#    .#
#######