# # # # # # # # # # # # #
#       #
#  P    #
#       #
#########
##